e_rebels
e_pirates
k_papal_state
k_orthodox
e_sunni
e_shiite
d_sunni
d_shiite
e_golden_horde
e_il-khanate
e_timurids
d_knights_templar
d_teutonic_order
d_knights_hospitaler
d_hashshashin
d_sunni_turkic_company
d_sunni_cuman_company
d_sunni_berber_company
d_sunni_bedouin_company
d_shiite_turkic_company
d_shiite_cuman_company
d_shiite_berber_company
d_shiite_bedouin_company
d_white_company
d_great_company
d_company_of_st_george
d_star_company
d_little_hat_company
d_rose_company
d_catalan_company
d_navarrese_company
d_swiss_company
d_breton_company
d_victual_brothers
d_varangian_guard
d_cuman_company
d_rus_company
d_pecheneg_company
d_bulgarian_company
d_turkic_company
d_lombard_band
d_swiss_band
d_breton_band
d_catalan_band
d_saxon_band
d_cuman_band
d_rus_band
d_pecheneg_band
d_bulgarian_band
d_turkic_band
d_mamluks
d_venetian_navy
d_genoese_navy
d_hanseatic_navy
d_frisian_navy
d_maghreb_corsairs
d_ghilman
e_hre
k_frisia	- [e_hre]
d_holland	- [k_frisia] [e_hre]
c_holland	- [d_holland] [k_frisia] [e_hre]
c_sticht	- [d_holland] [k_frisia] [e_hre]
c_westfriesland	- [d_holland] [k_frisia] [e_hre]
c_zeeland	- [d_holland] [k_frisia] [e_hre]
d_gelre	- [k_frisia] [e_hre]
c_gelre	- [d_gelre] [k_frisia] [e_hre]
c_ostfriesland	- [d_gelre] [k_frisia] [e_hre]
c_frisia	- [d_gelre] [k_frisia] [e_hre]
d_brabant	- [k_frisia] [e_hre]
c_brabant	- [d_brabant] [k_frisia] [e_hre]
c_hainaut	- [d_brabant] [k_frisia] [e_hre]
c_breda	- [d_brabant] [k_frisia] [e_hre]
d_flanders	- [k_frisia] [e_hre]
c_artois	- [d_flanders] [k_frisia] [e_hre]
c_boulogne	- [d_flanders] [k_frisia] [e_hre]
c_guines	- [d_flanders] [k_frisia] [e_hre]
c_yperen	- [d_flanders] [k_frisia] [e_hre]
c_brugge	- [d_flanders] [k_frisia] [e_hre]
c_gent	- [d_flanders] [k_frisia] [e_hre]
k_lotharingia	- [e_hre]
d_luxembourg	- [k_lotharingia] [e_hre]
c_luxembourg	- [d_luxembourg] [k_lotharingia] [e_hre]
c_liege	- [d_luxembourg] [k_lotharingia] [e_hre]
d_upper_lorraine	- [k_lotharingia] [e_hre]
c_verdun	- [d_upper_lorraine] [k_lotharingia] [e_hre]
c_lorraine	- [d_upper_lorraine] [k_lotharingia] [e_hre]
c_saintois	- [d_upper_lorraine] [k_lotharingia] [e_hre]
d_lower_lorraine	- [k_lotharingia] [e_hre]
c_pfalz	- [d_lower_lorraine] [k_lotharingia] [e_hre]
c_trier	- [d_lower_lorraine] [k_lotharingia] [e_hre]
c_metz	- [d_lower_lorraine] [k_lotharingia] [e_hre]
d_alsace 	- [k_lotharingia] [e_hre]
c_nordgau	- [d_alsace ] [k_lotharingia] [e_hre]
c_sundgau	- [d_alsace ] [k_lotharingia] [e_hre]
k_pomerania	- [e_hre]
d_mecklemburg	- [k_pomerania] [e_hre]
c_mecklemburg	- [d_mecklemburg] [k_pomerania] [e_hre]
c_rostock	- [d_mecklemburg] [k_pomerania] [e_hre]
c_werle	- [d_mecklemburg] [k_pomerania] [e_hre]
c_rugen	- [d_mecklemburg] [k_pomerania] [e_hre]
d_pommerania	- [k_pomerania] [e_hre]
c_wolgast	- [d_pommerania] [k_pomerania] [e_hre]
c_stettin	- [d_pommerania] [k_pomerania] [e_hre]
d_pomeralia	- [k_pomerania] [e_hre]
c_danzig	- [d_pomeralia] [k_pomerania] [e_hre]
c_chelminskie	- [d_pomeralia] [k_pomerania] [e_hre]
c_slupsk	- [d_pomeralia] [k_pomerania] [e_hre]
d_saxony	- [k_pomerania] [e_hre]
c_anhalt	- [d_saxony] [k_pomerania] [e_hre]
c_plauen	- [d_saxony] [k_pomerania] [e_hre]
c_weimar	- [d_saxony] [k_pomerania] [e_hre]
d_brandenburg	- [k_pomerania] [e_hre]
c_altmark	- [d_brandenburg] [k_pomerania] [e_hre]
c_brandenburg	- [d_brandenburg] [k_pomerania] [e_hre]
d_meissen	- [k_pomerania] [e_hre]
c_meissen	- [d_meissen] [k_pomerania] [e_hre]
c_lausitz	- [d_meissen] [k_pomerania] [e_hre]
k_bavaria	- [e_hre]
d_bavaria	- [k_bavaria] [e_hre]
c_kempten	- [d_bavaria] [k_bavaria] [e_hre]
c_oberbayern	- [d_bavaria] [k_bavaria] [e_hre]
c_salzburg	- [d_bavaria] [k_bavaria] [e_hre]
c_niederbayern	- [d_bavaria] [k_bavaria] [e_hre]
c_nurnberg	- [d_bavaria] [k_bavaria] [e_hre]
d_osterreich 	- [k_bavaria] [e_hre]
c_passau	- [d_osterreich ] [k_bavaria] [e_hre]
c_znojmo	- [d_osterreich ] [k_bavaria] [e_hre]
c_osterreich	- [d_osterreich ] [k_bavaria] [e_hre]
c_steiermark	- [d_osterreich ] [k_bavaria] [e_hre]
d_tyrol  	- [k_bavaria] [e_hre]
c_tirol	- [d_tyrol  ] [k_bavaria] [e_hre]
c_st_gallen	- [d_tyrol  ] [k_bavaria] [e_hre]
c_innsbruck	- [d_tyrol  ] [k_bavaria] [e_hre]
c_chur	- [d_tyrol  ] [k_bavaria] [e_hre]
d_carinthia	- [k_bavaria] [e_hre]
c_istria	- [d_carinthia] [k_bavaria] [e_hre]
c_krain	- [d_carinthia] [k_bavaria] [e_hre]
c_karnten	- [d_carinthia] [k_bavaria] [e_hre]
c_aquileia	- [d_carinthia] [k_bavaria] [e_hre]
k_germany	- [e_hre]
d_brunswick	- [k_germany] [e_hre]
c_celle	- [d_brunswick] [k_germany] [e_hre]
c_luneburg	- [d_brunswick] [k_germany] [e_hre]
c_braunschweig	- [d_brunswick] [k_germany] [e_hre]
c_oldenburg	- [d_brunswick] [k_germany] [e_hre]
c_osnabruck	- [d_brunswick] [k_germany] [e_hre]
c_gottingen	- [d_brunswick] [k_germany] [e_hre]
d_thuringia	- [k_germany] [e_hre]
c_thuringen	- [d_thuringia] [k_germany] [e_hre]
c_nassau	- [d_thuringia] [k_germany] [e_hre]
d_koln	- [k_germany] [e_hre]
c_koln	- [d_koln] [k_germany] [e_hre]
c_loon	- [d_koln] [k_germany] [e_hre]
c_munster	- [d_koln] [k_germany] [e_hre]
c_julich	- [d_koln] [k_germany] [e_hre]
c_kleve	- [d_koln] [k_germany] [e_hre]
d_franconia	- [k_germany] [e_hre]
c_mainz	- [d_franconia] [k_germany] [e_hre]
c_leiningen	- [d_franconia] [k_germany] [e_hre]
c_wurzburg	- [d_franconia] [k_germany] [e_hre]
c_bamberg	- [d_franconia] [k_germany] [e_hre]
d_baden 	- [k_germany] [e_hre]
c_baden	- [d_baden ] [k_germany] [e_hre]
c_breisgau	- [d_baden ] [k_germany] [e_hre]
d_swabia	- [k_germany] [e_hre]
c_schwaben	- [d_swabia] [k_germany] [e_hre]
c_ulm	- [d_swabia] [k_germany] [e_hre]
c_furstenberg	- [d_swabia] [k_germany] [e_hre]
c_wurttemberg	- [d_swabia] [k_germany] [e_hre]
k_bohemia	- [e_hre]
e_byzantium
k_byzantium	- [e_byzantium]
d_nikaea	- [k_byzantium] [e_byzantium]
c_nikaea	- [d_nikaea] [k_byzantium] [e_byzantium]
c_nikomedeia	- [d_nikaea] [k_byzantium] [e_byzantium]
c_prusa	- [d_nikaea] [k_byzantium] [e_byzantium]
c_kyzikos	- [d_nikaea] [k_byzantium] [e_byzantium]
d_samos	- [k_byzantium] [e_byzantium]
c_ephesos	- [d_samos] [k_byzantium] [e_byzantium]
c_smyrna	- [d_samos] [k_byzantium] [e_byzantium]
c_chios	- [d_samos] [k_byzantium] [e_byzantium]
d_aegean_islands	- [k_byzantium] [e_byzantium]
c_abydos	- [d_aegean_islands] [k_byzantium] [e_byzantium]
c_naxos	- [d_aegean_islands] [k_byzantium] [e_byzantium]
c_euboia	- [d_aegean_islands] [k_byzantium] [e_byzantium]
c_lesbos	- [d_aegean_islands] [k_byzantium] [e_byzantium]
d_thrace	- [k_byzantium] [e_byzantium]
c_kaliopolis	- [d_thrace] [k_byzantium] [e_byzantium]
c_byzantion	- [d_thrace] [k_byzantium] [e_byzantium]
c_thrake	- [d_thrace] [k_byzantium] [e_byzantium]
d_adrianopolis	- [k_byzantium] [e_byzantium]
c_adrianopolis	- [d_adrianopolis] [k_byzantium] [e_byzantium]
c_philippopolis	- [d_adrianopolis] [k_byzantium] [e_byzantium]
d_thessalonika	- [k_byzantium] [e_byzantium]
c_chalkidike	- [d_thessalonika] [k_byzantium] [e_byzantium]
c_thessalonike	- [d_thessalonika] [k_byzantium] [e_byzantium]
c_thessalia	- [d_thessalonika] [k_byzantium] [e_byzantium]
d_dyrrachion	- [k_byzantium] [e_byzantium]
c_strymon	- [d_dyrrachion] [k_byzantium] [e_byzantium]
c_ochrid	- [d_dyrrachion] [k_byzantium] [e_byzantium]
c_dyrrachion	- [d_dyrrachion] [k_byzantium] [e_byzantium]
d_epirus	- [k_byzantium] [e_byzantium]
c_epeiros	- [d_epirus] [k_byzantium] [e_byzantium]
c_arta	- [d_epirus] [k_byzantium] [e_byzantium]
c_cephalonia	- [d_epirus] [k_byzantium] [e_byzantium]
d_athens	- [k_byzantium] [e_byzantium]
c_demetrias	- [d_athens] [k_byzantium] [e_byzantium]
c_hellas	- [d_athens] [k_byzantium] [e_byzantium]
c_atheniai	- [d_athens] [k_byzantium] [e_byzantium]
d_achaia	- [k_byzantium] [e_byzantium]
c_achaia	- [d_achaia] [k_byzantium] [e_byzantium]
c_korinthos	- [d_achaia] [k_byzantium] [e_byzantium]
c_methone	- [d_achaia] [k_byzantium] [e_byzantium]
c_monemvasia	- [d_achaia] [k_byzantium] [e_byzantium]
d_krete	- [k_byzantium] [e_byzantium]
c_kaneia	- [d_krete] [k_byzantium] [e_byzantium]
c_chandax	- [d_krete] [k_byzantium] [e_byzantium]
d_cyprus	- [k_byzantium] [e_byzantium]
c_famagusta	- [d_cyprus] [k_byzantium] [e_byzantium]
c_limisol	- [d_cyprus] [k_byzantium] [e_byzantium]
d_cibyrrhaeot 	- [k_byzantium] [e_byzantium]
c_attaleia	- [d_cibyrrhaeot ] [k_byzantium] [e_byzantium]
c_rhodos	- [d_cibyrrhaeot ] [k_byzantium] [e_byzantium]
c_lykia	- [d_cibyrrhaeot ] [k_byzantium] [e_byzantium]
k_anatolia	- [e_byzantium]
d_anatolia	- [k_anatolia] [e_byzantium]
c_dorylaion	- [d_anatolia] [k_anatolia] [e_byzantium]
c_ikonion	- [d_anatolia] [k_anatolia] [e_byzantium]
d_thracesia	- [k_anatolia] [e_byzantium]
c_sozopolis	- [d_thracesia] [k_anatolia] [e_byzantium]
c_laodikeia	- [d_thracesia] [k_anatolia] [e_byzantium]
d_charsianon	- [k_anatolia] [e_byzantium]
c_kaisereia	- [d_charsianon] [k_anatolia] [e_byzantium]
c_galatia	- [d_charsianon] [k_anatolia] [e_byzantium]
c_tyana	- [d_charsianon] [k_anatolia] [e_byzantium]
d_armeniacon	- [k_anatolia] [e_byzantium]
c_amisos	- [d_armeniacon] [k_anatolia] [e_byzantium]
c_sinope	- [d_armeniacon] [k_anatolia] [e_byzantium]
d_paphlagonia	- [k_anatolia] [e_byzantium]
c_paphlagonia	- [d_paphlagonia] [k_anatolia] [e_byzantium]
c_herakleia	- [d_paphlagonia] [k_anatolia] [e_byzantium]
c_ankyra	- [d_paphlagonia] [k_anatolia] [e_byzantium]
d_trebizond	- [k_anatolia] [e_byzantium]
c_theodosiopolis	- [d_trebizond] [k_anatolia] [e_byzantium]
c_trapezous	- [d_trebizond] [k_anatolia] [e_byzantium]
c_chaldea	- [d_trebizond] [k_anatolia] [e_byzantium]
k_armenia	- [e_byzantium]
d_azerbaijan	- [k_armenia] [e_byzantium]
c_shirvan	- [d_azerbaijan] [k_armenia] [e_byzantium]
c_azerbaijan	- [d_azerbaijan] [k_armenia] [e_byzantium]
c_suenik	- [d_azerbaijan] [k_armenia] [e_byzantium]
c_shemakha	- [d_azerbaijan] [k_armenia] [e_byzantium]
d_armenia	- [k_armenia] [e_byzantium]
c_vaspurakan	- [d_armenia] [k_armenia] [e_byzantium]
c_dwin	- [d_armenia] [k_armenia] [e_byzantium]
c_ani	- [d_armenia] [k_armenia] [e_byzantium]
d_mesopotamia	- [k_armenia] [e_byzantium]
c_karin	- [d_mesopotamia] [k_armenia] [e_byzantium]
c_mesopotamia	- [d_mesopotamia] [k_armenia] [e_byzantium]
c_taron	- [d_mesopotamia] [k_armenia] [e_byzantium]
c_amida	- [d_mesopotamia] [k_armenia] [e_byzantium]
c_nisibin	- [d_mesopotamia] [k_armenia] [e_byzantium]
d_edessa	- [k_armenia] [e_byzantium]
c_edessa	- [d_edessa] [k_armenia] [e_byzantium]
c_tell_bashir	- [d_edessa] [k_armenia] [e_byzantium]
c_aintab	- [d_edessa] [k_armenia] [e_byzantium]
d_coloneia	- [k_armenia] [e_byzantium]
c_koloneia	- [d_coloneia] [k_armenia] [e_byzantium]
c_melitene	- [d_coloneia] [k_armenia] [e_byzantium]
d_armenia_minor	- [k_armenia] [e_byzantium]
c_lykandos	- [d_armenia_minor] [k_armenia] [e_byzantium]
c_tarsos	- [d_armenia_minor] [k_armenia] [e_byzantium]
c_adana	- [d_armenia_minor] [k_armenia] [e_byzantium]
c_teluch	- [d_armenia_minor] [k_armenia] [e_byzantium]
c_seleukeia	- [d_armenia_minor] [k_armenia] [e_byzantium]
k_bulgaria	- [e_byzantium]
d_vidin	- [k_bulgaria] [e_byzantium]
c_vidin	- [d_vidin] [k_bulgaria] [e_byzantium]
c_naissus	- [d_vidin] [k_bulgaria] [e_byzantium]
d_turnovo	- [k_bulgaria] [e_byzantium]
c_tyrnovo	- [d_turnovo] [k_bulgaria] [e_byzantium]
c_serdica	- [d_turnovo] [k_bulgaria] [e_byzantium]
c_nikopolis	- [d_turnovo] [k_bulgaria] [e_byzantium]
c_dorostotum	- [d_turnovo] [k_bulgaria] [e_byzantium]
d_karvuna	- [k_bulgaria] [e_byzantium]
c_mesembria	- [d_karvuna] [k_bulgaria] [e_byzantium]
c_karvuna	- [d_karvuna] [k_bulgaria] [e_byzantium]
c_constantia	- [d_karvuna] [k_bulgaria] [e_byzantium]
k_dacia	- [e_byzantium]
d_wallachia	- [k_dacia] [e_byzantium]
c_turnu	- [d_wallachia] [k_dacia] [e_byzantium]
c_tirgoviste	- [d_wallachia] [k_dacia] [e_byzantium]
c_severin	- [d_wallachia] [k_dacia] [e_byzantium]
c_galaz	- [d_wallachia] [k_dacia] [e_byzantium]
d_moldau	- [k_dacia] [e_byzantium]
c_peresechen	- [d_moldau] [k_dacia] [e_byzantium]
c_torki	- [d_moldau] [k_dacia] [e_byzantium]
c_olvia	- [d_moldau] [k_dacia] [e_byzantium]
c_belgorod	- [d_moldau] [k_dacia] [e_byzantium]
c_birlad	- [d_moldau] [k_dacia] [e_byzantium]
k_serbia	- [e_byzantium]
d_rashka	- [k_serbia] [e_byzantium]
c_rashka	- [d_rashka] [k_serbia] [e_byzantium]
c_hum	- [d_rashka] [k_serbia] [e_byzantium]
c_belgrade	- [d_rashka] [k_serbia] [e_byzantium]
d_dioclea	- [k_serbia] [e_byzantium]
c_zeta	- [d_dioclea] [k_serbia] [e_byzantium]
c_ragusa	- [d_dioclea] [k_serbia] [e_byzantium]
k_croatia	- [e_byzantium]
d_slavonia	- [k_croatia] [e_byzantium]
c_krizevci	- [d_slavonia] [k_croatia] [e_byzantium]
c_zagreb	- [d_slavonia] [k_croatia] [e_byzantium]
c_varadzin	- [d_slavonia] [k_croatia] [e_byzantium]
d_bosnia	- [k_croatia] [e_byzantium]
c_rama	- [d_bosnia] [k_croatia] [e_byzantium]
c_usora	- [d_bosnia] [k_croatia] [e_byzantium]
d_croatia	- [k_croatia] [e_byzantium]
c_zachlumia	- [d_croatia] [k_croatia] [e_byzantium]
c_senj	- [d_croatia] [k_croatia] [e_byzantium]
c_veglia	- [d_croatia] [k_croatia] [e_byzantium]
d_dalmatia	- [k_croatia] [e_byzantium]
c_split	- [d_dalmatia] [k_croatia] [e_byzantium]
c_zadar	- [d_dalmatia] [k_croatia] [e_byzantium]
k_sicily	- [e_byzantium]
d_benevento	- [k_sicily] [e_byzantium]
c_benevento	- [d_benevento] [k_sicily] [e_byzantium]
c_foggia	- [d_benevento] [k_sicily] [e_byzantium]
d_capua	- [k_sicily] [e_byzantium]
c_capua	- [d_capua] [k_sicily] [e_byzantium]
c_napoli	- [d_capua] [k_sicily] [e_byzantium]
d_apulia	- [k_sicily] [e_byzantium]
c_apulia	- [d_apulia] [k_sicily] [e_byzantium]
c_bari	- [d_apulia] [k_sicily] [e_byzantium]
c_lecce	- [d_apulia] [k_sicily] [e_byzantium]
d_salerno	- [k_sicily] [e_byzantium]
c_salerno	- [d_salerno] [k_sicily] [e_byzantium]
c_taranto	- [d_salerno] [k_sicily] [e_byzantium]
d_calabria	- [k_sicily] [e_byzantium]
c_consenza	- [d_calabria] [k_sicily] [e_byzantium]
c_reggio	- [d_calabria] [k_sicily] [e_byzantium]
d_sicily	- [k_sicily] [e_byzantium]
c_palermo	- [d_sicily] [k_sicily] [e_byzantium]
c_messina	- [d_sicily] [k_sicily] [e_byzantium]
c_siracusa	- [d_sicily] [k_sicily] [e_byzantium]
c_agrigento	- [d_sicily] [k_sicily] [e_byzantium]
c_trapani	- [d_sicily] [k_sicily] [e_byzantium]
c_malta	- [d_sicily] [k_sicily] [e_byzantium]
e_scandinavia
k_sweden	- [e_scandinavia]
d_uppland	- [k_sweden] [e_scandinavia]
c_uppland	- [d_uppland] [k_sweden] [e_scandinavia]
c_gastrikland	- [d_uppland] [k_sweden] [e_scandinavia]
c_aland	- [d_uppland] [k_sweden] [e_scandinavia]
d_ostergotland	- [k_sweden] [e_scandinavia]
c_ostergotland	- [d_ostergotland] [k_sweden] [e_scandinavia]
c_narke	- [d_ostergotland] [k_sweden] [e_scandinavia]
c_sodermanland	- [d_ostergotland] [k_sweden] [e_scandinavia]
d_vastergotland	- [k_sweden] [e_scandinavia]
c_vastergotland	- [d_vastergotland] [k_sweden] [e_scandinavia]
c_dal	- [d_vastergotland] [k_sweden] [e_scandinavia]
c_viken	- [d_vastergotland] [k_sweden] [e_scandinavia]
d_norrland 	- [k_sweden] [e_scandinavia]
c_lappland	- [d_norrland ] [k_sweden] [e_scandinavia]
c_vasterbotten	- [d_norrland ] [k_sweden] [e_scandinavia]
c_angermanland	- [d_norrland ] [k_sweden] [e_scandinavia]
c_medelpad	- [d_norrland ] [k_sweden] [e_scandinavia]
c_halsingland	- [d_norrland ] [k_sweden] [e_scandinavia]
d_bergslagen 	- [k_sweden] [e_scandinavia]
c_dalarna	- [d_bergslagen ] [k_sweden] [e_scandinavia]
c_varmland	- [d_bergslagen ] [k_sweden] [e_scandinavia]
c_vastmanland	- [d_bergslagen ] [k_sweden] [e_scandinavia]
d_smaland	- [k_sweden] [e_scandinavia]
c_smaland	- [d_smaland] [k_sweden] [e_scandinavia]
c_oland	- [d_smaland] [k_sweden] [e_scandinavia]
c_gotland	- [d_smaland] [k_sweden] [e_scandinavia]
k_denmark	- [e_scandinavia]
d_skane	- [k_denmark] [e_scandinavia]
c_skane	- [d_skane] [k_denmark] [e_scandinavia]
c_halland	- [d_skane] [k_denmark] [e_scandinavia]
c_bornholm	- [d_skane] [k_denmark] [e_scandinavia]
c_blekinge	- [d_skane] [k_denmark] [e_scandinavia]
d_sjaelland	- [k_denmark] [e_scandinavia]
c_sjaelland	- [d_sjaelland] [k_denmark] [e_scandinavia]
c_fyn	- [d_sjaelland] [k_denmark] [e_scandinavia]
d_slesvig	- [k_denmark] [e_scandinavia]
c_slesvig	- [d_slesvig] [k_denmark] [e_scandinavia]
c_jylland	- [d_slesvig] [k_denmark] [e_scandinavia]
d_holstein	- [k_denmark] [e_scandinavia]
c_hamburg	- [d_holstein] [k_denmark] [e_scandinavia]
c_lubeck	- [d_holstein] [k_denmark] [e_scandinavia]
c_holstein	- [d_holstein] [k_denmark] [e_scandinavia]
c_bremen	- [d_holstein] [k_denmark] [e_scandinavia]
k_norway	- [e_scandinavia]
d_iceland	- [k_norway] [e_scandinavia]
c_vestisland	- [d_iceland] [k_norway] [e_scandinavia]
c_austisland	- [d_iceland] [k_norway] [e_scandinavia]
d_orkney	- [k_norway] [e_scandinavia]
c_faereyar	- [d_orkney] [k_norway] [e_scandinavia]
c_shetland	- [d_orkney] [k_norway] [e_scandinavia]
c_orkney	- [d_orkney] [k_norway] [e_scandinavia]
d_vestlandet	- [k_norway] [e_scandinavia]
c_agder	- [d_vestlandet] [k_norway] [e_scandinavia]
c_rogaland	- [d_vestlandet] [k_norway] [e_scandinavia]
c_telemark	- [d_vestlandet] [k_norway] [e_scandinavia]
c_bergenshus	- [d_vestlandet] [k_norway] [e_scandinavia]
d_ostlandet	- [k_norway] [e_scandinavia]
c_vestfold	- [d_ostlandet] [k_norway] [e_scandinavia]
c_akershus	- [d_ostlandet] [k_norway] [e_scandinavia]
c_oppland	- [d_ostlandet] [k_norway] [e_scandinavia]
d_trondelag	- [k_norway] [e_scandinavia]
c_hedmark	- [d_trondelag] [k_norway] [e_scandinavia]
c_trondelag	- [d_trondelag] [k_norway] [e_scandinavia]
c_naumadal	- [d_trondelag] [k_norway] [e_scandinavia]
c_halogaland	- [d_trondelag] [k_norway] [e_scandinavia]
c_finnmark	- [d_trondelag] [k_norway] [e_scandinavia]
c_nordland	- [d_trondelag] [k_norway] [e_scandinavia]
d_jamtland	- [k_norway] [e_scandinavia]
c_jamtland	- [d_jamtland] [k_norway] [e_scandinavia]
c_herjedalen	- [d_jamtland] [k_norway] [e_scandinavia]
k_finland	- [e_scandinavia]
d_esthonia	- [k_finland] [e_scandinavia]
c_reval	- [d_esthonia] [k_finland] [e_scandinavia]
c_narva	- [d_esthonia] [k_finland] [e_scandinavia]
c_vodi	- [d_esthonia] [k_finland] [e_scandinavia]
d_karelia	- [k_finland] [e_scandinavia]
c_onega	- [d_karelia] [k_finland] [e_scandinavia]
c_karelen	- [d_karelia] [k_finland] [e_scandinavia]
c_kexholm	- [d_karelia] [k_finland] [e_scandinavia]
c_kola	- [d_karelia] [k_finland] [e_scandinavia]
c_kandalax	- [d_karelia] [k_finland] [e_scandinavia]
d_finland	- [k_finland] [e_scandinavia]
c_savolaks	- [d_finland] [k_finland] [e_scandinavia]
c_nyland	- [d_finland] [k_finland] [e_scandinavia]
c_finland	- [d_finland] [k_finland] [e_scandinavia]
c_tavasts	- [d_finland] [k_finland] [e_scandinavia]
c_satakunta	- [d_finland] [k_finland] [e_scandinavia]
c_osterbotten	- [d_finland] [k_finland] [e_scandinavia]
c_kemi	- [d_finland] [k_finland] [e_scandinavia]
k_poland
d_mazovia	- [k_poland]
c_jacwiez	- [d_mazovia] [k_poland]
c_plock	- [d_mazovia] [k_poland]
c_czersk	- [d_mazovia] [k_poland]
c_yatvyagi	- [d_mazovia] [k_poland]
d_greater_poland 	- [k_poland]
c_lubusz	- [d_greater_poland ] [k_poland]
c_gnieznienskie	- [d_greater_poland ] [k_poland]
c_poznanskie	- [d_greater_poland ] [k_poland]
c_kaliskie	- [d_greater_poland ] [k_poland]
d_silesia	- [k_poland]
c_lower_silesia	- [d_silesia] [k_poland]
c_upper_silesia	- [d_silesia] [k_poland]
c_opole	- [d_silesia] [k_poland]
c_cieszyn	- [d_silesia] [k_poland]
d_lesser_poland 	- [k_poland]
c_krakowskie	- [d_lesser_poland ] [k_poland]
c_sacz	- [d_lesser_poland ] [k_poland]
c_sandomierskie	- [d_lesser_poland ] [k_poland]
d_kuyavia 	- [k_poland]
c_sieradzko-leczyckie	- [d_kuyavia ] [k_poland]
c_kujawy	- [d_kuyavia ] [k_poland]
k_lithuania
d_livonia	- [k_lithuania]
c_lettigalians	- [d_livonia] [k_lithuania]
c_livs	- [d_livonia] [k_lithuania]
c_dorpat	- [d_livonia] [k_lithuania]
c_osel	- [d_livonia] [k_lithuania]
d_prussia	- [k_lithuania]
c_marienburg	- [d_prussia] [k_lithuania]
c_galindia	- [d_prussia] [k_lithuania]
c_sambia	- [d_prussia] [k_lithuania]
d_polotsk	- [k_lithuania]
c_polotsk	- [d_polotsk] [k_lithuania]
c_west_dvina	- [d_polotsk] [k_lithuania]
d_lithuanians	- [k_lithuania]
c_zhmud	- [d_lithuanians] [k_lithuania]
c_aukshayts	- [d_lithuanians] [k_lithuania]
c_sudovia	- [d_lithuanians] [k_lithuania]
d_courland 	- [k_lithuania]
c_zemigalians	- [d_courland ] [k_lithuania]
c_kurs	- [d_courland ] [k_lithuania]
d_samogitia	- [k_lithuania]
c_scalovia	- [d_samogitia] [k_lithuania]
c_memel	- [d_samogitia] [k_lithuania]
e_russia
k_rus	- [e_russia]
d_bjarmia	- [k_rus] [e_russia]
c_romny	- [d_bjarmia] [k_rus] [e_russia]
c_trans-portage	- [d_bjarmia] [k_rus] [e_russia]
c_north_dvina	- [d_bjarmia] [k_rus] [e_russia]
c_bjarmia	- [d_bjarmia] [k_rus] [e_russia]
c_samoyeds	- [d_bjarmia] [k_rus] [e_russia]
d_beloozero	- [k_rus] [e_russia]
c_beloozero	- [d_beloozero] [k_rus] [e_russia]
c_zaozerye	- [d_beloozero] [k_rus] [e_russia]
c_chud	- [d_beloozero] [k_rus] [e_russia]
c_vologda	- [d_beloozero] [k_rus] [e_russia]
d_novgorod	- [k_rus] [e_russia]
c_bezhetsky_verh	- [d_novgorod] [k_rus] [e_russia]
c_torzhok	- [d_novgorod] [k_rus] [e_russia]
c_novgorod	- [d_novgorod] [k_rus] [e_russia]
c_pskov	- [d_novgorod] [k_rus] [e_russia]
c_velikiye_luki	- [d_novgorod] [k_rus] [e_russia]
c_toropets	- [d_novgorod] [k_rus] [e_russia]
d_rostov	- [k_rus] [e_russia]
c_pereyaslavl_zalessky	- [d_rostov] [k_rus] [e_russia]
c_rostov	- [d_rostov] [k_rus] [e_russia]
c_uglich	- [d_rostov] [k_rus] [e_russia]
d_tver	- [k_rus] [e_russia]
c_tver	- [d_tver] [k_rus] [e_russia]
c_vyazma	- [d_tver] [k_rus] [e_russia]
d_yaroslavl	- [k_rus] [e_russia]
c_kostroma	- [d_yaroslavl] [k_rus] [e_russia]
c_yaroslavl	- [d_yaroslavl] [k_rus] [e_russia]
d_vladimir	- [k_rus] [e_russia]
c_galich_mersky	- [d_vladimir] [k_rus] [e_russia]
c_gorodez	- [d_vladimir] [k_rus] [e_russia]
c_nizhny_novgorod	- [d_vladimir] [k_rus] [e_russia]
c_suzdal	- [d_vladimir] [k_rus] [e_russia]
c_vladimir	- [d_vladimir] [k_rus] [e_russia]
d_moskva	- [k_rus] [e_russia]
c_mozhaysk	- [d_moskva] [k_rus] [e_russia]
c_moskva	- [d_moskva] [k_rus] [e_russia]
k_ruthenia	- [e_russia]
d_kiev	- [k_ruthenia] [e_russia]
c_korsun	- [d_kiev] [k_ruthenia] [e_russia]
c_kiev	- [d_kiev] [k_ruthenia] [e_russia]
d_galich	- [k_ruthenia] [e_russia]
c_terebovl	- [d_galich] [k_ruthenia] [e_russia]
c_galich	- [d_galich] [k_ruthenia] [e_russia]
c_peremyshl	- [d_galich] [k_ruthenia] [e_russia]
d_volhynia	- [k_ruthenia] [e_russia]
c_podlasie	- [d_volhynia] [k_ruthenia] [e_russia]
c_vladimir_volynsky	- [d_volhynia] [k_ruthenia] [e_russia]
c_beresty	- [d_volhynia] [k_ruthenia] [e_russia]
d_turov	- [k_ruthenia] [e_russia]
c_turov	- [d_turov] [k_ruthenia] [e_russia]
c_pinsk	- [d_turov] [k_ruthenia] [e_russia]
d_vitebsk	- [k_ruthenia] [e_russia]
c_minsk	- [d_vitebsk] [k_ruthenia] [e_russia]
c_orsha	- [d_vitebsk] [k_ruthenia] [e_russia]
c_vitebsk	- [d_vitebsk] [k_ruthenia] [e_russia]
d_smolensk	- [k_ruthenia] [e_russia]
c_smolensk	- [d_smolensk] [k_ruthenia] [e_russia]
c_mstislavl	- [d_smolensk] [k_ruthenia] [e_russia]
d_chernigov	- [k_ruthenia] [e_russia]
c_lyubech	- [d_chernigov] [k_ruthenia] [e_russia]
c_chernigov	- [d_chernigov] [k_ruthenia] [e_russia]
d_novgorod-seversk 	- [k_ruthenia] [e_russia]
c_novgorod_seversky	- [d_novgorod-seversk ] [k_ruthenia] [e_russia]
c_bryansk	- [d_novgorod-seversk ] [k_ruthenia] [e_russia]
d_ryazan	- [k_ruthenia] [e_russia]
c_pronsk	- [d_ryazan] [k_ruthenia] [e_russia]
c_murom	- [d_ryazan] [k_ruthenia] [e_russia]
c_ryazan	- [d_ryazan] [k_ruthenia] [e_russia]
c_kolomna	- [d_ryazan] [k_ruthenia] [e_russia]
d_pereyaslavl	- [k_ruthenia] [e_russia]
c_pereyaslavl	- [d_pereyaslavl] [k_ruthenia] [e_russia]
c_chortitza	- [d_pereyaslavl] [k_ruthenia] [e_russia]
k_volga_bulgaria	- [e_russia]
d_bulgar 	- [k_volga_bulgaria] [e_russia]
c_kama	- [d_bulgar ] [k_volga_bulgaria] [e_russia]
c_bilyar	- [d_bulgar ] [k_volga_bulgaria] [e_russia]
c_bulgar	- [d_bulgar ] [k_volga_bulgaria] [e_russia]
c_syrt	- [d_bulgar ] [k_volga_bulgaria] [e_russia]
c_southern_ural	- [d_bulgar ] [k_volga_bulgaria] [e_russia]
c_bashkirs	- [d_bulgar ] [k_volga_bulgaria] [e_russia]
d_cheremisa 	- [k_volga_bulgaria] [e_russia]
c_grassland_cheremisa	- [d_cheremisa ] [k_volga_bulgaria] [e_russia]
c_merya	- [d_cheremisa ] [k_volga_bulgaria] [e_russia]
c_chuvash	- [d_cheremisa ] [k_volga_bulgaria] [e_russia]
c_mountain_cheremisa	- [d_cheremisa ] [k_volga_bulgaria] [e_russia]
c_burtasy	- [d_cheremisa ] [k_volga_bulgaria] [e_russia]
c_mordva	- [d_cheremisa ] [k_volga_bulgaria] [e_russia]
k_perm	- [e_russia]
d_perm	- [k_perm] [e_russia]
c_perm	- [d_perm] [k_perm] [e_russia]
c_votyaki	- [d_perm] [k_perm] [e_russia]
c_yamalia	- [d_perm] [k_perm] [e_russia]
c_komi	- [d_perm] [k_perm] [e_russia]
c_chelyabi	- [d_perm] [k_perm] [e_russia]
c_khantia	- [d_perm] [k_perm] [e_russia]
d_hlynov	- [k_perm] [e_russia]
c_hlynov	- [d_hlynov] [k_perm] [e_russia]
c_zyriane	- [d_hlynov] [k_perm] [e_russia]
c_ugra	- [d_hlynov] [k_perm] [e_russia]
c_syrj	- [d_hlynov] [k_perm] [e_russia]
c_veliky_ustug	- [d_hlynov] [k_perm] [e_russia]
d_tyumen	- [k_perm] [e_russia]
c_tyumen	- [d_tyumen] [k_perm] [e_russia]
c_mansia	- [d_tyumen] [k_perm] [e_russia]
c_surgut	- [d_tyumen] [k_perm] [e_russia]
c_oral	- [d_tyumen] [k_perm] [e_russia]
k_cuman
d_itil	- [k_cuman]
c_itil	- [d_itil] [k_cuman]
c_guryev	- [d_itil] [k_cuman]
c_yaik	- [d_itil] [k_cuman]
c_uzens	- [d_itil] [k_cuman]
c_lower_volga	- [d_itil] [k_cuman]
c_saray	- [d_itil] [k_cuman]
d_sarkel	- [k_cuman]
c_khopyor	- [d_sarkel] [k_cuman]
c_sugrov	- [d_sarkel] [k_cuman]
c_desht-i-kipchak	- [d_sarkel] [k_cuman]
c_sarkel	- [d_sarkel] [k_cuman]
c_don_portage	- [d_sarkel] [k_cuman]
c_sharukan	- [d_sarkel] [k_cuman]
k_taurica
d_cherson	- [k_taurica]
c_theodosia	- [d_cherson] [k_taurica]
c_korchev	- [d_cherson] [k_taurica]
c_cherson	- [d_cherson] [k_taurica]
c_tmutarakan	- [d_cherson] [k_taurica]
d_crimea 	- [k_taurica]
c_lower_don	- [d_crimea ] [k_taurica]
c_oleshye	- [d_crimea ] [k_taurica]
c_lukomorie	- [d_crimea ] [k_taurica]
c_lower_dniepr	- [d_crimea ] [k_taurica]
c_crimea	- [d_crimea ] [k_taurica]
k_alania
d_alania	- [k_alania]
c_sarpa	- [d_alania] [k_alania]
c_yegorlyk	- [d_alania] [k_alania]
c_manych	- [d_alania] [k_alania]
c_alania	- [d_alania] [k_alania]
c_kuma	- [d_alania] [k_alania]
d_azov	- [k_alania]
c_tana	- [d_azov] [k_alania]
c_azov	- [d_azov] [k_alania]
c_kuban	- [d_azov] [k_alania]
k_khwarizm
d_khwarizmian	- [k_khwarizm]
c_khwarizm	- [d_khwarizmian] [k_khwarizm]
c_emba	- [d_khwarizmian] [k_khwarizm]
c_mangyshlak	- [d_khwarizmian] [k_khwarizm]
c_aral	- [d_khwarizmian] [k_khwarizm]
c_usturt	- [d_khwarizmian] [k_khwarizm]
d_aktobe	- [k_khwarizm]
c_ryn_desert	- [d_aktobe] [k_khwarizm]
c_aqtobe	- [d_aktobe] [k_khwarizm]
c_omsk	- [d_aktobe] [k_khwarizm]
e_persia
k_persia	- [e_persia]
d_merv 	- [k_persia] [e_persia]
c_merv	- [d_merv ] [k_persia] [e_persia]
c_turkmen	- [d_merv ] [k_persia] [e_persia]
c_dihistan	- [d_merv ] [k_persia] [e_persia]
d_khorasan	- [k_persia] [e_persia]
c_khorasan	- [d_khorasan] [k_persia] [e_persia]
c_gurgan	- [d_khorasan] [k_persia] [e_persia]
c_nishapur	- [d_khorasan] [k_persia] [e_persia]
c_qohistan	- [d_khorasan] [k_persia] [e_persia]
c_lut	- [d_khorasan] [k_persia] [e_persia]
d_mazandaran	- [k_persia] [e_persia]
c_tabaristan	- [d_mazandaran] [k_persia] [e_persia]
c_mazandaran	- [d_mazandaran] [k_persia] [e_persia]
c_qwivir	- [d_mazandaran] [k_persia] [e_persia]
d_esfahan	- [k_persia] [e_persia]
c_esfahan	- [d_esfahan] [k_persia] [e_persia]
c_yazd	- [d_esfahan] [k_persia] [e_persia]
c_avhaz	- [d_esfahan] [k_persia] [e_persia]
c_shiraz	- [d_esfahan] [k_persia] [e_persia]
d_hormuz	- [k_persia] [e_persia]
c_sistan	- [d_hormuz] [k_persia] [e_persia]
c_hormuz	- [d_hormuz] [k_persia] [e_persia]
c_kerman	- [d_hormuz] [k_persia] [e_persia]
c_ladistan	- [d_hormuz] [k_persia] [e_persia]
c_zermanya	- [d_hormuz] [k_persia] [e_persia]
d_fars	- [k_persia] [e_persia]
c_fars	- [d_fars] [k_persia] [e_persia]
c_hendjan	- [d_fars] [k_persia] [e_persia]
c_khozistan	- [d_fars] [k_persia] [e_persia]
d_hamadan	- [k_persia] [e_persia]
c_qom	- [d_hamadan] [k_persia] [e_persia]
c_hamadan	- [d_hamadan] [k_persia] [e_persia]
c_rayy	- [d_hamadan] [k_persia] [e_persia]
d_birjand	- [k_persia] [e_persia]
c_birjand	- [d_birjand] [k_persia] [e_persia]
c_farrah	- [d_birjand] [k_persia] [e_persia]
c_zahedan	- [d_birjand] [k_persia] [e_persia]
c_bam	- [d_birjand] [k_persia] [e_persia]
c_jask	- [d_birjand] [k_persia] [e_persia]
c_tis	- [d_birjand] [k_persia] [e_persia]
c_sabzevar	- [d_birjand] [k_persia] [e_persia]
c_baluchistan	- [d_birjand] [k_persia] [e_persia]
k_qarakhnid	- [e_persia]
d_khiva	- [k_qarakhnid # Actually Khiva] [e_persia]
c_khiva	- [d_khiva] [k_qarakhnid # Actually Khiva] [e_persia]
c_kyzylorda	- [d_khiva] [k_qarakhnid # Actually Khiva] [e_persia]
c_dashhowuz	- [d_khiva] [k_qarakhnid # Actually Khiva] [e_persia]
c_samarkand	- [d_khiva] [k_qarakhnid # Actually Khiva] [e_persia]
c_balkh	- [d_khiva] [k_qarakhnid # Actually Khiva] [e_persia]
c_herat	- [d_khiva] [k_qarakhnid # Actually Khiva] [e_persia]
d_bukhara	- [k_qarakhnid # Actually Khiva] [e_persia]
c_kara-kum	- [d_bukhara] [k_qarakhnid # Actually Khiva] [e_persia]
c_maverannahr	- [d_bukhara] [k_qarakhnid # Actually Khiva] [e_persia]
c_bukhara	- [d_bukhara] [k_qarakhnid # Actually Khiva] [e_persia]
k_mesopotamia	- [e_persia]
d_kermanshah	- [k_mesopotamia] [e_persia]
c_qazwin	- [d_kermanshah] [k_mesopotamia] [e_persia]
c_dailam	- [d_kermanshah] [k_mesopotamia] [e_persia]
c_kermanshah	- [d_kermanshah] [k_mesopotamia] [e_persia]
c_luristan	- [d_kermanshah] [k_mesopotamia] [e_persia]
d_tigris	- [k_mesopotamia] [e_persia]
c_al_nadjaf	- [d_tigris] [k_mesopotamia] [e_persia]
c_ilam	- [d_tigris] [k_mesopotamia] [e_persia]
c_tigris	- [d_tigris] [k_mesopotamia] [e_persia]
c_al_amarah	- [d_tigris] [k_mesopotamia] [e_persia]
c_al_nasiryah	- [d_tigris] [k_mesopotamia] [e_persia]
d_basra	- [k_mesopotamia] [e_persia]
c_kufa	- [d_basra] [k_mesopotamia] [e_persia]
c_rummah	- [d_basra] [k_mesopotamia] [e_persia]
c_kuwait	- [d_basra] [k_mesopotamia] [e_persia]
c_basra	- [d_basra] [k_mesopotamia] [e_persia]
d_baghdad	- [k_mesopotamia] [e_persia]
c_karbala	- [d_baghdad] [k_mesopotamia] [e_persia]
c_baghdad	- [d_baghdad] [k_mesopotamia] [e_persia]
c_al_habbariyah	- [d_baghdad] [k_mesopotamia] [e_persia]
c_deir	- [d_baghdad] [k_mesopotamia] [e_persia]
c_euphrates	- [d_baghdad] [k_mesopotamia] [e_persia]
c_kirkuk	- [d_baghdad] [k_mesopotamia] [e_persia]
d_mosul	- [k_mesopotamia] [e_persia]
c_mosul	- [d_mosul] [k_mesopotamia] [e_persia]
c_kurdistan	- [d_mosul] [k_mesopotamia] [e_persia]
c_al_jazira	- [d_mosul] [k_mesopotamia] [e_persia]
c_al_bichri	- [d_mosul] [k_mesopotamia] [e_persia]
c_sinjar	- [d_mosul] [k_mesopotamia] [e_persia]
c_bira	- [d_mosul] [k_mesopotamia] [e_persia]
d_tabriz	- [k_mesopotamia] [e_persia]
c_oromieh	- [d_tabriz] [k_mesopotamia] [e_persia]
c_gilan	- [d_tabriz] [k_mesopotamia] [e_persia]
c_tabriz	- [d_tabriz] [k_mesopotamia] [e_persia]
k_georgia
d_kartli	- [k_georgia]
c_kartli	- [d_kartli] [k_georgia]
c_tao	- [d_kartli] [k_georgia]
c_guria	- [d_kartli] [k_georgia]
c_kakheti	- [d_kartli] [k_georgia]
d_derbent	- [k_georgia]
c_albania	- [d_derbent] [k_georgia]
c_derbent	- [d_derbent] [k_georgia]
c_semender	- [d_derbent] [k_georgia]
d_abkhazia	- [k_georgia]
c_imeretia	- [d_abkhazia] [k_georgia]
c_kasogs	- [d_abkhazia] [k_georgia]
c_abkhazia	- [d_abkhazia] [k_georgia]
k_hungary
d_pecs	- [k_hungary]
c_pecs	- [d_pecs] [k_hungary]
c_szekezfehervar	- [d_pecs] [k_hungary]
c_vas	- [d_pecs] [k_hungary]
c_fejer	- [d_pecs] [k_hungary]
d_esztergom	- [k_hungary]
c_sopron	- [d_esztergom] [k_hungary]
c_esztergom	- [d_esztergom] [k_hungary]
c_pressburg	- [d_esztergom] [k_hungary]
d_nyitra	- [k_hungary]
c_nitra	- [d_nyitra] [k_hungary]
c_trencin	- [d_nyitra] [k_hungary]
c_gemer	- [d_nyitra] [k_hungary]
c_orava	- [d_nyitra] [k_hungary]
d_ungvar	- [k_hungary]
c_saris	- [d_ungvar] [k_hungary]
c_bereg	- [d_ungvar] [k_hungary]
c_abauj	- [d_ungvar] [k_hungary]
c_marmaros	- [d_ungvar] [k_hungary]
d_pest	- [k_hungary]
c_heves	- [d_pest] [k_hungary]
c_pest	- [d_pest] [k_hungary]
c_csanad	- [d_pest] [k_hungary]
d_transylvania	- [k_hungary]
c_szekelyfold	- [d_transylvania] [k_hungary]
c_bihar	- [d_transylvania] [k_hungary]
c_feher	- [d_transylvania] [k_hungary]
d_temes	- [k_hungary]
c_temes	- [d_temes] [k_hungary]
c_bacs	- [d_temes] [k_hungary]
k_italy
d_venice	- [k_italy]
c_venezia	- [d_venice] [k_italy]
d_verona	- [k_italy]
c_treviso	- [d_verona] [k_italy]
c_verona	- [d_verona] [k_italy]
c_padova	- [d_verona] [k_italy]
c_mantua	- [d_verona] [k_italy]
d_susa	- [k_italy]
c_piemonte	- [d_susa] [k_italy]
c_saluzzo	- [d_susa] [k_italy]
c_monferrato	- [d_susa] [k_italy]
d_lombardia	- [k_italy]
c_brescia	- [d_lombardia] [k_italy]
c_lombardia	- [d_lombardia] [k_italy]
c_trent	- [d_lombardia] [k_italy]
c_pavia	- [d_lombardia] [k_italy]
c_cremona	- [d_lombardia] [k_italy]
d_genoa	- [k_italy]
c_genoa	- [d_genoa] [k_italy]
c_nice	- [d_genoa] [k_italy]
d_modena	- [k_italy]
c_modena	- [d_modena] [k_italy]
c_parma	- [d_modena] [k_italy]
d_ferrara	- [k_italy]
c_bologna	- [d_ferrara] [k_italy]
c_ferrara	- [d_ferrara] [k_italy]
c_ravenna	- [d_ferrara] [k_italy]
d_toscana	- [k_italy]
c_lucca	- [d_toscana] [k_italy]
c_firenze	- [d_toscana] [k_italy]
c_siena	- [d_toscana] [k_italy]
d_pisa	- [k_italy]
c_pisa	- [d_pisa] [k_italy]
c_piombino	- [d_pisa] [k_italy]
d_ancona	- [k_italy]
c_ancona	- [d_ancona] [k_italy]
c_urbino	- [d_ancona] [k_italy]
d_spoleto	- [k_italy]
c_spoleto	- [d_spoleto] [k_italy]
c_aprutium	- [d_spoleto] [k_italy]
d_latium	- [k_italy]
c_roma	- [d_latium] [k_italy]
c_orvieto	- [d_latium] [k_italy]
c_orbetello	- [d_latium] [k_italy]
d_sardinia	- [k_italy]
c_corsica	- [d_sardinia] [k_italy]
c_arborea	- [d_sardinia] [k_italy]
c_cagliari	- [d_sardinia] [k_italy]
e_france
k_france	- [e_france]
d_berry	- [k_france] [e_france]
c_tourraine	- [d_berry] [k_france] [e_france]
c_bourges	- [d_berry] [k_france] [e_france]
d_anjou	- [k_france] [e_france]
c_anjou	- [d_anjou] [k_france] [e_france]
c_maine	- [d_anjou] [k_france] [e_france]
d_normandy	- [k_france] [e_france]
c_evreux	- [d_normandy] [k_france] [e_france]
c_avranches	- [d_normandy] [k_france] [e_france]
c_vexin	- [d_normandy] [k_france] [e_france]
c_arques	- [d_normandy] [k_france] [e_france]
c_eu	- [d_normandy] [k_france] [e_france]
d_orleans	- [k_france] [e_france]
c_orleans	- [d_orleans] [k_france] [e_france]
c_blois	- [d_orleans] [k_france] [e_france]
c_vendome	- [d_orleans] [k_france] [e_france]
c_chartres	- [d_orleans] [k_france] [e_france]
d_champagne	- [k_france] [e_france]
c_troyes	- [d_champagne] [k_france] [e_france]
c_reims	- [d_champagne] [k_france] [e_france]
c_sens	- [d_champagne] [k_france] [e_france]
d_valois	- [k_france] [e_france]
c_ile_de_france	- [d_valois] [k_france] [e_france]
c_vermandois	- [d_valois] [k_france] [e_france]
c_amiens	- [d_valois] [k_france] [e_france]
d_burgundy	- [k_france] [e_france]
c_chalons	- [d_burgundy] [k_france] [e_france]
c_auxerre	- [d_burgundy] [k_france] [e_france]
c_macon	- [d_burgundy] [k_france] [e_france]
c_dijon	- [d_burgundy] [k_france] [e_france]
c_nevers	- [d_burgundy] [k_france] [e_france]
c_charolais	- [d_burgundy] [k_france] [e_france]
k_aquitaine	- [e_france]
d_aquitaine	- [k_aquitaine] [e_france]
c_bordeaux	- [d_aquitaine] [k_aquitaine] [e_france]
c_agen	- [d_aquitaine] [k_aquitaine] [e_france]
c_perigord	- [d_aquitaine] [k_aquitaine] [e_france]
c_angouleme	- [d_aquitaine] [k_aquitaine] [e_france]
d_toulouse	- [k_aquitaine] [e_france]
c_montpellier	- [d_toulouse] [k_aquitaine] [e_france]
c_viviers	- [d_toulouse] [k_aquitaine] [e_france]
c_narbonne	- [d_toulouse] [k_aquitaine] [e_france]
c_carcassonne	- [d_toulouse] [k_aquitaine] [e_france]
c_toulouse	- [d_toulouse] [k_aquitaine] [e_france]
c_rouergue	- [d_toulouse] [k_aquitaine] [e_france]
d_gascogne	- [k_aquitaine] [e_france]
c_foix	- [d_gascogne] [k_aquitaine] [e_france]
c_bearn	- [d_gascogne] [k_aquitaine] [e_france]
c_armagnac	- [d_gascogne] [k_aquitaine] [e_france]
c_labourd	- [d_gascogne] [k_aquitaine] [e_france]
c_albret	- [d_gascogne] [k_aquitaine] [e_france]
d_poitou	- [k_aquitaine] [e_france]
c_lusignan	- [d_poitou] [k_aquitaine] [e_france]
c_saintonge	- [d_poitou] [k_aquitaine] [e_france]
c_poitiers	- [d_poitou] [k_aquitaine] [e_france]
c_thouars	- [d_poitou] [k_aquitaine] [e_france]
d_auvergne	- [k_aquitaine] [e_france]
c_auvergne	- [d_auvergne] [k_aquitaine] [e_france]
c_gevaudan	- [d_auvergne] [k_aquitaine] [e_france]
d_bourbon	- [k_aquitaine] [e_france]
c_bourbon	- [d_bourbon] [k_aquitaine] [e_france]
c_limousin	- [d_bourbon] [k_aquitaine] [e_france]
c_la_marche	- [d_bourbon] [k_aquitaine] [e_france]
k_brittany	- [e_france]
d_brittany	- [k_brittany] [e_france]
c_nantes	- [d_brittany] [k_brittany] [e_france]
c_vannes	- [d_brittany] [k_brittany] [e_france]
c_cornouaille	- [d_brittany] [k_brittany] [e_france]
c_french_leon	- [d_brittany] [k_brittany] [e_france]
c_penthievre	- [d_brittany] [k_brittany] [e_france]
c_rennes	- [d_brittany] [k_brittany] [e_france]
k_burgundy	- [e_france]
d_provence	- [k_burgundy] [e_france]
c_provence	- [d_provence] [k_burgundy] [e_france]
c_forcalquier	- [d_provence] [k_burgundy] [e_france]
c_venaissin	- [d_provence] [k_burgundy] [e_france]
d_savoie	- [k_burgundy] [e_france]
c_savoie	- [d_savoie] [k_burgundy] [e_france]
c_valais	- [d_savoie] [k_burgundy] [e_france]
c_geneve	- [d_savoie] [k_burgundy] [e_france]
d_dauphine	- [k_burgundy] [e_france]
c_dauphine_viennois	- [d_dauphine] [k_burgundy] [e_france]
c_lyon	- [d_dauphine] [k_burgundy] [e_france]
c_forez	- [d_dauphine] [k_burgundy] [e_france]
d_upper_burgundy	- [k_burgundy] [e_france]
c_grisons	- [d_upper_burgundy] [k_burgundy] [e_france]
c_neuchatel	- [d_upper_burgundy] [k_burgundy] [e_france]
c_bern	- [d_upper_burgundy] [k_burgundy] [e_france]
c_schwyz	- [d_upper_burgundy] [k_burgundy] [e_france]
c_aargau	- [d_upper_burgundy] [k_burgundy] [e_france]
c_besancon	- [d_upper_burgundy] [k_burgundy] [e_france]
e_spain
k_castille - [e_spain]
d_castilla	- [k_castille #Spain] [e_spain]
c_burgos	- [d_castilla] [k_castille #Spain] [e_spain]
c_valladolid	- [d_castilla] [k_castille #Spain] [e_spain]
c_soria	- [d_castilla] [k_castille #Spain] [e_spain]
c_asturias_de_santillana	- [d_castilla] [k_castille #Spain] [e_spain]
k_aragon	- [e_spain]
d_aragon	- [k_aragon] [e_spain]
c_albarracin	- [d_aragon] [k_aragon] [e_spain]
c_alto_aragon	- [d_aragon] [k_aragon] [e_spain]
c_zaragoza	- [d_aragon] [k_aragon] [e_spain]
c_calatayud	- [d_aragon] [k_aragon] [e_spain]
d_barcelona	- [k_aragon] [e_spain]
c_barcelona	- [d_barcelona] [k_aragon] [e_spain]
c_urgell	- [d_barcelona] [k_aragon] [e_spain]
c_rosello	- [d_barcelona] [k_aragon] [e_spain]
c_empuries	- [d_barcelona] [k_aragon] [e_spain]
c_lleida	- [d_barcelona] [k_aragon] [e_spain]
c_tarragona	- [d_barcelona] [k_aragon] [e_spain]
d_valencia	- [k_aragon] [e_spain]
c_castellon	- [d_valencia] [k_aragon] [e_spain]
c_valencia	- [d_valencia] [k_aragon] [e_spain]
c_denia	- [d_valencia] [k_aragon] [e_spain]
d_mallorca	- [k_aragon] [e_spain]
c_mallorca	- [d_mallorca] [k_aragon] [e_spain]
c_menorca	- [d_mallorca] [k_aragon] [e_spain]
k_navarra	- [e_spain]
d_navarra	- [k_navarra] [e_spain]
c_viscaya	- [d_navarra] [k_navarra] [e_spain]
c_navarra	- [d_navarra] [k_navarra] [e_spain]
c_najera	- [d_navarra] [k_navarra] [e_spain]
k_leon	- [e_spain]
d_asturias	- [k_leon] [e_spain]
c_asturias_de_oviedo	- [d_asturias] [k_leon] [e_spain]
c_astorga	- [d_asturias] [k_leon] [e_spain]
d_leon	- [k_leon] [e_spain]
c_leon	- [d_leon] [k_leon] [e_spain]
c_zamora	- [d_leon] [k_leon] [e_spain]
c_salamanca	- [d_leon] [k_leon] [e_spain]
k_spanish_galicia	- [e_spain]
d_galicia	- [k_spanish_galicia] [e_spain]
c_coruna	- [d_galicia] [k_spanish_galicia] [e_spain]
c_santiago	- [d_galicia] [k_spanish_galicia] [e_spain]
d_porto	- [k_spanish_galicia] [e_spain]
c_porto	- [d_porto] [k_spanish_galicia] [e_spain]
c_braganza	- [d_porto] [k_spanish_galicia] [e_spain]
c_castelo_branco	- [d_porto] [k_spanish_galicia] [e_spain]
c_coimbra	- [d_porto] [k_spanish_galicia] [e_spain]
k_portugal	- [e_spain]
d_beja	- [k_portugal] [e_spain]
c_lisboa	- [d_beja] [k_portugal] [e_spain]
c_evora	- [d_beja] [k_portugal] [e_spain]
c_alcacer_do_sal	- [d_beja] [k_portugal] [e_spain]
c_mertola	- [d_beja] [k_portugal] [e_spain]
d_algarve	- [k_portugal] [e_spain]
c_silves	- [d_algarve] [k_portugal] [e_spain]
c_faro	- [d_algarve] [k_portugal] [e_spain]
k_andalusia	- [e_spain]
d_cordoba	- [k_andalusia] [e_spain]
c_cordoba	- [d_cordoba] [k_andalusia] [e_spain]
c_la_mancha	- [d_cordoba] [k_andalusia] [e_spain]
c_calatrava	- [d_cordoba] [k_andalusia] [e_spain]
d_murcia	- [k_andalusia] [e_spain]
c_almansa	- [d_murcia] [k_andalusia] [e_spain]
c_murcia	- [d_murcia] [k_andalusia] [e_spain]
d_granada	- [k_andalusia] [e_spain]
c_granada	- [d_granada] [k_andalusia] [e_spain]
c_almeria	- [d_granada] [k_andalusia] [e_spain]
c_malaga	- [d_granada] [k_andalusia] [e_spain]
d_sevilla	- [k_andalusia] [e_spain]
c_sevilla	- [d_sevilla] [k_andalusia] [e_spain]
c_cadiz	- [d_sevilla] [k_andalusia] [e_spain]
c_algeciras	- [d_sevilla] [k_andalusia] [e_spain]
c_aracena	- [d_sevilla] [k_andalusia] [e_spain]
c_niebla	- [d_sevilla] [k_andalusia] [e_spain]
d_badajoz	- [k_andalusia] [e_spain]
c_plasencia	- [d_badajoz] [k_andalusia] [e_spain]
c_alcantara	- [d_badajoz] [k_andalusia] [e_spain]
c_caceres	- [d_badajoz] [k_andalusia] [e_spain]
c_badajoz	- [d_badajoz] [k_andalusia] [e_spain]
d_toledo	- [k_andalusia] [e_spain]
c_toledo	- [d_toledo] [k_andalusia] [e_spain]
c_molina	- [d_toledo] [k_andalusia] [e_spain]
c_cuenca	- [d_toledo] [k_andalusia] [e_spain]
e_arabia
k_arabia	- [e_arabia]
d_arabia_petrae	- [k_arabia] [e_arabia]
c_al_aqabah	- [d_arabia_petrae] [k_arabia] [e_arabia]
c_ar_ar	- [d_arabia_petrae] [k_arabia] [e_arabia]
c_maan	- [d_arabia_petrae] [k_arabia] [e_arabia]
c_tabuk	- [d_arabia_petrae] [k_arabia] [e_arabia]
c_petra	- [d_arabia_petrae] [k_arabia] [e_arabia]
d_medina	- [k_arabia] [e_arabia]
c_al_jawf	- [d_medina] [k_arabia] [e_arabia]
c_hijaz	- [d_medina] [k_arabia] [e_arabia]
c_medina	- [d_medina] [k_arabia] [e_arabia]
c_mecca	- [d_medina] [k_arabia] [e_arabia]
c_asir	- [d_medina] [k_arabia] [e_arabia]
d_sanaa	- [k_arabia] [e_arabia]
c_bayda	- [d_sanaa] [k_arabia] [e_arabia]
c_sanaa	- [d_sanaa] [k_arabia] [e_arabia]
c_taizz	- [d_sanaa] [k_arabia] [e_arabia]
c_aden	- [d_sanaa] [k_arabia] [e_arabia]
c_kathiri	- [d_sanaa] [k_arabia] [e_arabia]
d_oman	- [k_arabia] [e_arabia]
c_dhu_zabi	- [d_oman] [k_arabia] [e_arabia]
c_hajar	- [d_oman] [k_arabia] [e_arabia]
c_muscat	- [d_oman] [k_arabia] [e_arabia]
c_duqm	- [d_oman] [k_arabia] [e_arabia]
c_dhofar	- [d_oman] [k_arabia] [e_arabia]
c_mahra	- [d_oman] [k_arabia] [e_arabia]
d_nefoud	- [k_arabia] [e_arabia]
c_rafha	- [d_nefoud] [k_arabia] [e_arabia]
c_hail	- [d_nefoud] [k_arabia] [e_arabia]
c_hajr	- [d_nefoud] [k_arabia] [e_arabia]
c_halaban	- [d_nefoud] [k_arabia] [e_arabia]
d_amman	- [k_arabia] [e_arabia]
c_damman	- [d_amman] [k_arabia] [e_arabia]
c_al_hasa	- [d_amman] [k_arabia] [e_arabia]
c_bahrein	- [d_amman] [k_arabia] [e_arabia]
k_egypt	- [e_arabia]
d_alexandria	- [k_egypt] [e_arabia]
c_alexandria	- [d_alexandria] [k_egypt] [e_arabia]
c_al_alamayn	- [d_alexandria] [k_egypt] [e_arabia]
c_quattara	- [d_alexandria] [k_egypt] [e_arabia]
c_buhairya	- [d_alexandria] [k_egypt] [e_arabia]
c_gizeh	- [d_alexandria] [k_egypt] [e_arabia]
d_damietta	- [k_egypt] [e_arabia]
c_gabiyaha	- [d_damietta] [k_egypt] [e_arabia]
c_delta	- [d_damietta] [k_egypt] [e_arabia]
c_pelusia	- [d_damietta] [k_egypt] [e_arabia]
c_manupura	- [d_damietta] [k_egypt] [e_arabia]
d_cairo	- [k_egypt] [e_arabia]
c_cairo	- [d_cairo] [k_egypt] [e_arabia]
c_sarqihya	- [d_cairo] [k_egypt] [e_arabia]
c_quena	- [d_cairo] [k_egypt] [e_arabia]
c_asyut	- [d_cairo] [k_egypt] [e_arabia]
d_aswan	- [k_egypt] [e_arabia]
c_aswan	- [d_aswan] [k_egypt] [e_arabia]
c_makuria	- [d_aswan] [k_egypt] [e_arabia]
c_nubia	- [d_aswan] [k_egypt] [e_arabia]
d_sinai	- [k_egypt] [e_arabia]
c_farama	- [d_sinai] [k_egypt] [e_arabia]
c_sinai	- [d_sinai] [k_egypt] [e_arabia]
c_eilat	- [d_sinai] [k_egypt] [e_arabia]
c_el-arish	- [d_sinai] [k_egypt] [e_arabia]
k_jerusalem	- [e_arabia]
d_oultrejourdain	- [k_jerusalem] [e_arabia]
c_negev	- [d_oultrejourdain] [k_jerusalem] [e_arabia]
c_monreal	- [d_oultrejourdain] [k_jerusalem] [e_arabia]
c_kerak	- [d_oultrejourdain] [k_jerusalem] [e_arabia]
c_madaba	- [d_oultrejourdain] [k_jerusalem] [e_arabia]
d_ascalon	- [k_jerusalem] [e_arabia]
c_darum	- [d_ascalon] [k_jerusalem] [e_arabia]
c_jaffa	- [d_ascalon] [k_jerusalem] [e_arabia]
c_ascalon	- [d_ascalon] [k_jerusalem] [e_arabia]
c_beersheb	- [d_ascalon] [k_jerusalem] [e_arabia]
d_jerusalem	- [k_jerusalem] [e_arabia]
c_jerusalem	- [d_jerusalem] [k_jerusalem] [e_arabia]
c_acre	- [d_jerusalem] [k_jerusalem] [e_arabia]
c_hebron	- [d_jerusalem] [k_jerusalem] [e_arabia]
d_galilee	- [k_jerusalem] [e_arabia]
c_tiberias	- [d_galilee] [k_jerusalem] [e_arabia]
c_tyrus	- [d_galilee] [k_jerusalem] [e_arabia]
c_beirut	- [d_galilee] [k_jerusalem] [e_arabia]
c_safed	- [d_galilee] [k_jerusalem] [e_arabia]
k_syria	- [e_arabia]
d_aleppo	- [k_syria] [e_arabia]
c_asas	- [d_aleppo] [k_syria] [e_arabia]
c_palmyra	- [d_aleppo] [k_syria] [e_arabia]
c_aleppo	- [d_aleppo] [k_syria] [e_arabia]
c_homs	- [d_aleppo] [k_syria] [e_arabia]
c_hama	- [d_aleppo] [k_syria] [e_arabia]
d_antioch	- [k_syria] [e_arabia]
c_antiocheia	- [d_antioch] [k_syria] [e_arabia]
c_archa	- [d_antioch] [k_syria] [e_arabia]
c_alexandretta	- [d_antioch] [k_syria] [e_arabia]
d_tripoli	- [k_syria] [e_arabia]
c_tortosa	- [d_tripoli] [k_syria] [e_arabia]
c_tripoli	- [d_tripoli] [k_syria] [e_arabia]
c_baalbek	- [d_tripoli] [k_syria] [e_arabia]
d_damascus	- [k_syria] [e_arabia]
c_damascus	- [d_damascus] [k_syria] [e_arabia]
c_irbid	- [d_damascus] [k_syria] [e_arabia]
c_al_mafraq	- [d_damascus] [k_syria] [e_arabia]
c_az_zarqa	- [d_damascus] [k_syria] [e_arabia]
c_amman	- [d_damascus] [k_syria] [e_arabia]
d_syria	- [k_syria] [e_arabia]
c_syria	- [d_syria] [k_syria] [e_arabia]
c_druz	- [d_syria] [k_syria] [e_arabia]
c_suwaida	- [d_syria] [k_syria] [e_arabia]
c_tadmor	- [d_syria] [k_syria] [e_arabia]
k_mauretania	- [e_arabia]
d_marrakech	- [k_mauretania] [e_arabia]
c_marrakech	- [d_marrakech] [k_mauretania] [e_arabia]
c_tharasset	- [d_marrakech] [k_mauretania] [e_arabia]
c_ifni	- [d_marrakech] [k_mauretania] [e_arabia]
c_anti-atlas	- [d_marrakech] [k_mauretania] [e_arabia]
c_massat	- [d_marrakech] [k_mauretania] [e_arabia]
c_canarias	- [d_marrakech] [k_mauretania] [e_arabia]
d_tangiers	- [k_mauretania] [e_arabia]
c_infa	- [d_tangiers] [k_mauretania] [e_arabia]
c_tangiers	- [d_tangiers] [k_mauretania] [e_arabia]
c_cebta	- [d_tangiers] [k_mauretania] [e_arabia]
d_fes	- [k_mauretania] [e_arabia]
c_fes	- [d_fes] [k_mauretania] [e_arabia]
c_el_rif	- [d_fes] [k_mauretania] [e_arabia]
c_figuig	- [d_fes] [k_mauretania] [e_arabia]
c_sijilmasa	- [d_fes] [k_mauretania] [e_arabia]
d_alger	- [k_mauretania] [e_arabia]
c_atlas_mnt	- [d_alger] [k_mauretania] [e_arabia]
c_lemdiyya	- [d_alger] [k_mauretania] [e_arabia]
c_al_djazair	- [d_alger] [k_mauretania] [e_arabia]
c_mzab	- [d_alger] [k_mauretania] [e_arabia]
c_ouled_nail	- [d_alger] [k_mauretania] [e_arabia]
c_biskra	- [d_alger] [k_mauretania] [e_arabia]
d_tlemcen	- [k_mauretania] [e_arabia]
c_tlemcen	- [d_tlemcen] [k_mauretania] [e_arabia]
c_orania	- [d_tlemcen] [k_mauretania] [e_arabia]
c_hanyan	- [d_tlemcen] [k_mauretania] [e_arabia]
c_snassen	- [d_tlemcen] [k_mauretania] [e_arabia]
k_africa	- [e_arabia]
d_tunis	- [k_africa] [e_arabia]
c_tunis	- [d_tunis] [k_africa] [e_arabia]
c_medjerda	- [d_tunis] [k_africa] [e_arabia]
c_bizerte	- [d_tunis] [k_africa] [e_arabia]
c_kairwan	- [d_tunis] [k_africa] [e_arabia]
c_mahdia	- [d_tunis] [k_africa] [e_arabia]
c_gabes	- [d_tunis] [k_africa] [e_arabia]
d_tripolitania	- [k_africa] [e_arabia]
c_tripolitana	- [d_tripolitania] [k_africa] [e_arabia]
c_djerba	- [d_tripolitania] [k_africa] [e_arabia]
c_leptis_magna	- [d_tripolitania] [k_africa] [e_arabia]
c_syrte	- [d_tripolitania] [k_africa] [e_arabia]
d_cyrenaica	- [k_africa] [e_arabia]
c_cyrenaica	- [d_cyrenaica] [k_africa] [e_arabia]
c_senoussi	- [d_cyrenaica] [k_africa] [e_arabia]
c_benghazi	- [d_cyrenaica] [k_africa] [e_arabia]
c_tobruk	- [d_cyrenaica] [k_africa] [e_arabia]
d_kabylia	- [k_africa] [e_arabia]
c_beni_yanni	- [d_kabylia] [k_africa] [e_arabia]
c_tell_atlas	- [d_kabylia] [k_africa] [e_arabia]
c_constantine	- [d_kabylia] [k_africa] [e_arabia]
c_bejaija	- [d_kabylia] [k_africa] [e_arabia]
c_annaba	- [d_kabylia] [k_africa] [e_arabia]
k_abyssinia
d_harer	- [k_abyssinia]
c_busaso	- [d_harer] [k_abyssinia]
c_berbera	- [d_harer] [k_abyssinia]
c_harer	- [d_harer] [k_abyssinia]
c_tadjoura	- [d_harer] [k_abyssinia]
d_axum	- [k_abyssinia]
c_aksum	- [d_axum] [k_abyssinia]
c_akordat	- [d_axum] [k_abyssinia]
c_kassala	- [d_axum] [k_abyssinia]
c_hayya	- [d_axum] [k_abyssinia]
c_atbara	- [d_axum] [k_abyssinia]
c_sennar	- [d_axum] [k_abyssinia]
d_gondar	- [k_abyssinia]
c_asosa	- [d_gondar] [k_abyssinia]
c_ankober	- [d_gondar] [k_abyssinia]
c_gondar	- [d_gondar] [k_abyssinia]
c_antalo	- [d_gondar] [k_abyssinia]
c_matamma	- [d_gondar] [k_abyssinia]
e_britannia
k_england	- [e_britannia]
d_northumberland	- [k_england] [e_britannia]
c_northumberland	- [d_northumberland] [k_england] [e_britannia]
c_durham	- [d_northumberland] [k_england] [e_britannia]
c_cumberland	- [d_northumberland] [k_england] [e_britannia]
d_lancaster	- [k_england] [e_britannia]
c_lancaster	- [d_lancaster] [k_england] [e_britannia]
c_westmorland	- [d_lancaster] [k_england] [e_britannia]
c_chester	- [d_lancaster] [k_england] [e_britannia]
c_derby	- [d_lancaster] [k_england] [e_britannia]
d_york	- [k_england] [e_britannia]
c_york	- [d_york] [k_england] [e_britannia]
c_leicester	- [d_york] [k_england] [e_britannia]
c_lincoln	- [d_york] [k_england] [e_britannia]
d_norfolk	- [k_england] [e_britannia]
c_norfolk	- [d_norfolk] [k_england] [e_britannia]
c_suffolk	- [d_norfolk] [k_england] [e_britannia]
d_oxford	- [k_england] [e_britannia]
c_northampton	- [d_oxford] [k_england] [e_britannia]
c_oxford	- [d_oxford] [k_england] [e_britannia]
d_bedford	- [k_england] [e_britannia]
c_bedford	- [d_bedford] [k_england] [e_britannia]
c_middlesex	- [d_bedford] [k_england] [e_britannia]
c_essex	- [d_bedford] [k_england] [e_britannia]
d_hereford	- [k_england] [e_britannia]
c_hereford	- [d_hereford] [k_england] [e_britannia]
c_shrewsbury	- [d_hereford] [k_england] [e_britannia]
c_warwick	- [d_hereford] [k_england] [e_britannia]
c_worcester	- [d_hereford] [k_england] [e_britannia]
d_gloucester	- [k_england] [e_britannia]
c_gloucester	- [d_gloucester] [k_england] [e_britannia]
c_wiltshire	- [d_gloucester] [k_england] [e_britannia]
d_canterbury	- [k_england] [e_britannia]
c_surrey	- [d_canterbury] [k_england] [e_britannia]
c_kent	- [d_canterbury] [k_england] [e_britannia]
c_sussex	- [d_canterbury] [k_england] [e_britannia]
d_somerset	- [k_england] [e_britannia]
c_winchester	- [d_somerset] [k_england] [e_britannia]
c_dorset	- [d_somerset] [k_england] [e_britannia]
c_somerset	- [d_somerset] [k_england] [e_britannia]
k_wales	- [e_britannia]
d_gwynedd	- [k_wales] [e_britannia]
c_gwynedd	- [d_gwynedd] [k_wales] [e_britannia]
c_perfeddwlad	- [d_gwynedd] [k_wales] [e_britannia]
c_powys	- [d_gwynedd] [k_wales] [e_britannia]
d_deheubarth	- [k_wales] [e_britannia]
c_dyfed	- [d_deheubarth] [k_wales] [e_britannia]
c_glamorgan	- [d_deheubarth] [k_wales] [e_britannia]
c_gwent	- [d_deheubarth] [k_wales] [e_britannia]
d_cornwall	- [k_wales] [e_britannia]
c_cornwall	- [d_cornwall] [k_wales] [e_britannia]
c_devon	- [d_cornwall] [k_wales] [e_britannia]
k_scotland	- [e_britannia]
d_galloway	- [k_scotland] [e_britannia]
c_galloway	- [d_galloway] [k_scotland] [e_britannia]
c_carrick	- [d_galloway] [k_scotland] [e_britannia]
c_clydesdale	- [d_galloway] [k_scotland] [e_britannia]
d_western_isles	- [k_scotland] [e_britannia]
c_innse_gall	- [d_western_isles] [k_scotland] [e_britannia]
c_isle_of_man	- [d_western_isles] [k_scotland] [e_britannia]
c_argyll	- [d_western_isles] [k_scotland] [e_britannia]
d_lothian	- [k_scotland] [e_britannia]
c_lothian	- [d_lothian] [k_scotland] [e_britannia]
c_dunbar	- [d_lothian] [k_scotland] [e_britannia]
c_teviotdale	- [d_lothian] [k_scotland] [e_britannia]
d_albany	- [k_scotland] [e_britannia]
c_gowrie	- [d_albany] [k_scotland] [e_britannia]
c_fife	- [d_albany] [k_scotland] [e_britannia]
c_strathearn	- [d_albany] [k_scotland] [e_britannia]
c_atholl	- [d_albany] [k_scotland] [e_britannia]
d_moray	- [k_scotland] [e_britannia]
c_moray	- [d_moray] [k_scotland] [e_britannia]
c_ross	- [d_moray] [k_scotland] [e_britannia]
c_buchan	- [d_moray] [k_scotland] [e_britannia]
c_caithness	- [d_moray] [k_scotland] [e_britannia]
k_ireland	- [e_britannia]
d_ulster	- [k_ireland] [e_britannia]
c_ulster	- [d_ulster] [k_ireland] [e_britannia]
c_oriel	- [d_ulster] [k_ireland] [e_britannia]
c_tyrone	- [d_ulster] [k_ireland] [e_britannia]
c_tyrconnell	- [d_ulster] [k_ireland] [e_britannia]
d_connacht	- [k_ireland] [e_britannia]
c_breifne	- [d_connacht] [k_ireland] [e_britannia]
c_connacht	- [d_connacht] [k_ireland] [e_britannia]
d_meath	- [k_ireland] [e_britannia]
c_kildare	- [d_meath] [k_ireland] [e_britannia]
c_dublin	- [d_meath] [k_ireland] [e_britannia]
d_leinster	- [k_ireland] [e_britannia]
c_leinster	- [d_leinster] [k_ireland] [e_britannia]
c_ossory	- [d_leinster] [k_ireland] [e_britannia]
d_munster	- [k_ireland] [e_britannia]
c_thomond	- [d_munster] [k_ireland] [e_britannia]
c_ormond	- [d_munster] [k_ireland] [e_britannia]
c_desmond	- [d_munster] [k_ireland] [e_britannia]
k_mali
d_timbuktu	- [k_mali]
c_timbuktu	- [d_timbuktu] [k_mali]
c_oualata	- [d_timbuktu] [k_mali]
c_araouane	- [d_timbuktu] [k_mali]
c_taghaza	- [d_timbuktu] [k_mali]
d_ghana	- [k_mali]
c_ghana	- [d_ghana] [k_mali]
c_aoudaghost	- [d_ghana] [k_mali]
c_ouadane	- [d_ghana] [k_mali]
c_idjil	- [d_ghana] [k_mali]
d_mali	- [k_mali]
c_mali	- [d_mali] [k_mali]
c_bambuk	- [d_mali] [k_mali]
c_djenne	- [d_mali] [k_mali]
c_gurma	- [d_mali] [k_mali]
d_songhay	- [k_mali]
c_gao	- [d_songhay] [k_mali]
c_tadmekka	- [d_songhay] [k_mali]
c_zarma	- [d_songhay] [k_mali]
d_abbasid
d_arabia_felix
d_arabs
d_assassin
d_balearic
d_belgrade
d_bergen
d_bordeaux
d_braganza
d_butrinto
d_campania
d_catalonia
d_chaldea
d_cumberland
d_curonian
d_don
d_dorostotum
d_el_rif
d_el-arish
d_erzerum
d_estonia
d_galatia
d_georgia
d_gilan
d_hellas
d_ikonion
d_ingers
d_kajaneborg
d_kappadokia
d_karnten
d_kexholm
d_khazars
d_kirkuk
d_kola
d_krakow
d_laodikeia
d_lettigalians
d_luristan
d_lut
d_lykia
d_mar
d_milano
d_minsk
d_mordvins
d_nikomedeia
d_pechenegs
d_pressburg
d_pronsk
d_pruthenians
d_qom
d_romagna
d_the_isles
d_salamanca
d_sames
d_sandomiersk
d_satakunta
d_shiraz
d_sinope
d_sistan
d_slovakia
d_swiss
d_tavasts
d_turkmens
d_ural
d_varna
d_wielkopolska
d_vlachs
d_volga
d_votes
d_yatviags
d_zara
d_zaragoza
d_zemigalians
k_almohad
k_al-murabitids
k_aydin
k_cyprus
k_beni_helal
k_candar
k_khazaria
k_eretnid
k_fatimids
k_germiyan
k_hammadid
k_kafsid
k_karaman
k_marinid
k_mentese
k_naples
k_bosnia
k_nubia
k_ottoman
k_rum
k_saruhan
k_seljuk_turks
k_tekke
k_trebizond
k_trinacria
k_venice
k_zenata
k_zirid
k_ziyanids
e_latin_empire
e_byzantium	- [d_songhay] [e_latin_empire]
